Rk,Player,School,Conf,G,Rec,Yds,Avg,TD,Att,Yds,Avg,TD,Plays,Yds,Avg,TD
1,Devin Smith*\devin-smith-2,Ohio State,Big Ten,14,33,931,28.2,12,0,0,,0,33,931,28.2,12
2,Phillip Dorsett*\phillip-dorsett-1,Miami (FL),ACC,12,36,871,24.2,10,2,-6,-3.0,0,38,865,22.8,10
3,Chris Moore*\chris-moore-4,Cincinnati,American,11,30,673,22.4,8,0,0,,0,30,673,22.4,8
4,Sammie Coates*\sammie-coates-1,Auburn,SEC,12,34,741,21.8,4,0,0,,0,34,741,21.8,4
5,Ian Hamilton*\ian-hamilton-1,UTEP,CUSA,12,27,579,21.4,2,0,0,,0,27,579,21.4,2
6,Breshad Perriman*\breshad-perriman-1,UCF,American,13,50,1044,20.9,9,1,0,0.0,0,51,1044,20.5,9
7,Travin Dural*\travin-dural-1,LSU,SEC,13,37,758,20.5,7,10,111,11.1,0,47,869,18.5,7
8,Deandre Smelter*\deandre-smelter-1,Georgia Tech,ACC,10,35,715,20.4,7,3,103,34.3,1,38,818,21.5,8
9,Glenn Coleman\glenn-coleman-1,Florida International,CUSA,11,23,468,20.3,3,2,4,2.0,0,25,472,18.9,3
10,Devante Parker*\devante-parker-1,Louisville,ACC,6,43,855,19.9,5,0,0,,0,43,855,19.9,5
11,Leonte Carroo*\leonte-carroo-1,Rutgers,Big Ten,13,55,1086,19.7,10,0,0,,0,55,1086,19.7,10
12,Carlos Henderson*\carlos-henderson-1,Louisiana Tech,CUSA,12,29,569,19.6,4,13,72,5.5,0,42,641,15.3,4
13,Rokeem Williams\rokeem-williams-1,Miami (OH),MAC,10,35,682,19.5,3,5,4,0.8,0,40,686,17.2,3
14,Mario Hull*\mario-hull-1,Rice,CUSA,11,32,621,19.4,8,0,0,,0,32,621,19.4,8
15,Thomas Duarte*\thomas-duarte-1,UCLA,Pac-12,10,28,540,19.3,4,0,0,,0,28,540,19.3,4
16,Darius Jennings\darius-jennings-1,Virginia,ACC,12,27,521,19.3,2,24,115,4.8,1,51,636,12.5,3
17,Sterling Shepard*\sterling-shepard-1,Oklahoma,Big 12,11,51,970,19.0,5,8,41,5.1,0,59,1011,17.1,5
18,Darren Carrington*\darren-carrington-1,Oregon,Pac-12,10,37,704,19.0,4,0,0,,0,37,704,19.0,4
19,Devin Lauderdale\devin-lauderdale-1,Texas Tech,Big 12,10,31,589,19.0,7,0,0,,0,31,589,19.0,7
20,Keith Mumphery*\keith-mumphery-1,Michigan State,Big Ten,12,26,495,19.0,3,6,85,14.2,1,32,580,18.1,4
21,Brandon Sheperd*\brandon-sheperd-1,Oklahoma State,Big 12,13,39,737,18.9,5,4,69,17.3,0,43,806,18.7,5
22,Jalen Robinette*\jalen-robinette-1,Air Force,MWC,13,43,806,18.7,4,0,0,,0,43,806,18.7,4
23,J.J. Nelson\jamarcus-nelson-1,UAB,CUSA,12,35,655,18.7,4,5,45,9.0,0,40,700,17.5,4
24,Cam Worthy*\cam-worthy-1,East Carolina,American,11,55,1016,18.5,4,0,0,,0,55,1016,18.5,4
25,Tony Lippett*\tony-lippett-1,Michigan State,Big Ten,13,65,1198,18.4,11,2,51,25.5,1,67,1249,18.6,12
26,Kolby Listenbee*\kolby-listenbee-1,Texas Christian,Big 12,13,41,753,18.4,4,2,19,9.5,0,43,772,18.0,4
27,Chris Conley*\chris-conley-1,Georgia,SEC,13,36,657,18.3,8,0,0,,0,36,657,18.3,8
28,Rashard Higgins*\rashard-higgins-1,Colorado State,MWC,12,96,1750,18.2,17,0,0,,0,96,1750,18.2,17
29,Corey Davis*\corey-davis-3,Western Michigan,MAC,12,78,1408,18.1,15,0,0,,0,78,1408,18.1,15
30,Mike Williams*\mike-williams-17,Clemson,ACC,12,57,1030,18.1,6,0,0,,0,57,1030,18.1,6
31,Javess Blue\javess-blue-1,Kentucky,SEC,11,29,525,18.1,5,0,0,,0,29,525,18.1,5
32,Nigel King\nigel-king-1,Kansas,Big 12,11,30,537,17.9,1,0,0,,0,30,537,17.9,1
33,K.D. Cannon*\kd-cannon-1,Baylor,Big 12,13,58,1030,17.8,8,2,12,6.0,0,60,1042,17.4,8
34,Vince Sanders*\vince-sanders-1,Ole Miss,SEC,11,39,696,17.8,6,0,0,,0,39,696,17.8,6
35,C.J. Prosise\cj-prosise-1,Notre Dame,Ind,13,29,516,17.8,2,10,126,12.6,1,39,642,16.5,3
36,Devante Davis\devante-davis-1,UNLV,MWC,8,34,599,17.6,4,0,0,,0,34,599,17.6,4
37,Corey Coleman*\corey-coleman-1,Baylor,Big 12,10,64,1119,17.5,11,11,53,4.8,1,75,1172,15.6,12
38,Jimmie Hunt*\jimmie-hunt-1,Missouri,SEC,12,40,698,17.5,7,0,0,,0,40,698,17.5,7
39,Mack Hollins*\mack-hollins-1,North Carolina,ACC,13,35,613,17.5,8,0,0,,0,35,613,17.5,8
40,Charles Lovett*\charles-lovett-1,Colorado State,MWC,13,28,490,17.5,3,2,15,7.5,0,30,505,16.8,3
41,Evan Engram*\evan-engram-1,Ole Miss,SEC,10,38,662,17.4,2,0,0,,0,38,662,17.4,2
42,Dijon Paschal*\dijon-paschal-1,Arkansas State,Sun Belt,12,37,642,17.4,4,0,0,,0,37,642,17.4,4
43,Thomas Sperbeck*\thomas-sperbeck-1,Boise State,MWC,11,51,877,17.2,3,2,11,5.5,0,53,888,16.8,3
44,Taywan Taylor*\taywan-taylor-1,Western Kentucky,CUSA,12,45,767,17.0,7,1,11,11.0,0,46,778,16.9,7
45,Jordan Westerkamp\jordan-westerkamp-1,Nebraska,Big Ten,13,44,747,17.0,5,0,0,,0,44,747,17.0,5
46,Kenny Bell\kenny-bell-2,Nebraska,Big Ten,13,47,788,16.8,6,0,0,,0,47,788,16.8,6
47,Markeith Ambles*\markeith-ambles-2,Houston,American,13,32,539,16.8,4,0,0,,0,32,539,16.8,4
48,Devon Allen*\devon-allen-1,Oregon,Pac-12,14,41,684,16.7,7,1,21,21.0,0,42,705,16.8,7
49,Trevor Davis\trevor-davis-1,California,Pac-12,9,24,399,16.6,5,0,0,,0,24,399,16.6,5
50,Pharoh Cooper*\pharoh-cooper-1,South Carolina,SEC,13,69,1136,16.5,9,27,200,7.4,2,96,1336,13.9,11
51,Mekale McKay*\mekale-mckay-3,Cincinnati,American,13,44,725,16.5,8,0,0,,0,44,725,16.5,8
52,Andre Davis\andre-davis-4,South Florida,American,8,36,594,16.5,7,0,0,,0,36,594,16.5,7
53,Jordan Villamin\jordan-villamin-1,Oregon State,Pac-12,10,35,578,16.5,6,0,0,,0,35,578,16.5,6
54,Der'Rikk Thompson\derrikk-thompson-1,SMU,American,9,31,512,16.5,1,2,0,0.0,0,33,512,15.5,1
55,Matt Miller*\matt-miller-6,Boise State,MWC,5,28,461,16.5,3,0,0,,0,28,461,16.5,3
56,Devon Cajuste*\devon-cajuste-1,Stanford,Pac-12,10,34,557,16.4,6,0,0,,0,34,557,16.4,6
57,Titus Davis*\titus-davis-1,Central Michigan,MAC,10,60,980,16.3,13,3,20,6.7,0,63,1000,15.9,13
58,Malachi Jones\malachi-jones-1,Appalachian State,Sun Belt,12,36,585,16.3,3,0,0,,0,36,585,16.3,3
59,Fred Ross*\fred-ross-1,Mississippi State,SEC,11,30,489,16.3,5,2,6,3.0,0,32,495,15.5,5
60,Rodney Mills\rodney-mills-1,Massachusetts,MAC,12,30,489,16.3,5,0,0,,0,30,489,16.3,5
61,James Washington*\james-washington-5,Oklahoma State,Big 12,12,28,456,16.3,6,1,20,20.0,0,29,476,16.4,6
62,Tyler Boyd*\tyler-boyd-1,Pitt,ACC,13,78,1261,16.2,8,12,63,5.3,0,90,1324,14.7,8
63,Antonio Vaughan\antonio-vaughan-1,Old Dominion,CUSA,12,63,1019,16.2,12,6,31,5.2,0,69,1050,15.2,12
64,Josh Reynolds*\josh-reynolds-1,Texas A&M,SEC,13,52,842,16.2,13,0,0,,0,52,842,16.2,13
65,D'Haquille Williams*\dhaquille-williams-1,Auburn,SEC,10,45,730,16.2,5,0,0,,0,45,730,16.2,5
66,Danny Anthrop\danny-anthrop-1,Purdue,Big Ten,9,38,616,16.2,4,3,10,3.3,0,41,626,15.3,4
67,Deante' Gray*\deante-gray-1,Texas Christian,Big 12,11,36,582,16.2,8,8,88,11.0,0,44,670,15.2,8
68,Jesse Kroll*\jesse-kroll-1,Central Michigan,MAC,11,36,582,16.2,4,3,16,5.3,0,39,598,15.3,4
69,Ezell Ruffin*\ezell-ruffin-1,San Diego State,MWC,7,26,422,16.2,2,2,-2,-1.0,0,28,420,15.0,2
70,David Frazier\david-frazier-2,Miami (OH),MAC,11,59,949,16.1,5,1,5,5.0,0,60,954,15.9,5
71,Samajie Grant*\samajie-grant-1,Arizona,Pac-12,13,45,718,16.0,6,2,9,4.5,0,47,727,15.5,6
72,Maxx Williams*\maxx-williams-1,Minnesota,Big Ten,12,36,569,15.8,8,0,0,,0,36,569,15.8,8
73,C.J. Duncan\cj-duncan-1,Vanderbilt,SEC,11,28,441,15.8,4,2,4,2.0,0,30,445,14.8,4
74,Da'Ron Brown*\daron-brown-1,Northern Illinois,MAC,14,68,1065,15.7,6,10,108,10.8,1,78,1173,15.0,7
75,Josh Doctson*\josh-doctson-1,Texas Christian,Big 12,13,65,1018,15.7,11,0,0,,0,65,1018,15.7,11
76,James Quick*\james-quick-1,Louisville,ACC,12,36,566,15.7,3,2,9,4.5,0,38,575,15.1,3
77,Jordan Taylor*\jordan-taylor-2,Rice,CUSA,10,54,842,15.6,7,0,0,,0,54,842,15.6,7
78,John Harris*\john-harris-1,Texas,Big 12,13,68,1051,15.5,7,0,0,,0,68,1051,15.5,7
79,Jean Sifrin\jean-sifrin-1,Massachusetts,MAC,11,41,637,15.5,6,0,0,,0,41,637,15.5,6
80,Miles Gooch\miles-gooch-1,Virginia,ACC,7,24,371,15.5,1,0,0,,0,24,371,15.5,1
81,Ron Willoughby\ron-willoughby-1,Buffalo,MAC,11,50,771,15.4,9,0,0,,0,50,771,15.4,9
82,Clive Walford*\clive-walford-1,Miami (FL),ACC,11,44,676,15.4,7,0,0,,0,44,676,15.4,7
83,Jay Lee*\jay-lee-1,Baylor,Big 12,10,41,633,15.4,6,0,0,,0,41,633,15.4,6
84,Joe Hansley*\joe-hansley-1,Colorado State,MWC,11,35,540,15.4,2,7,13,1.9,0,42,553,13.2,2
85,Steve Ishmael\steve-ishmael-1,Syracuse,ACC,10,27,415,15.4,3,0,0,,0,27,415,15.4,3
86,Montez McGuire\montez-mcguire-1,Appalachian State,Sun Belt,11,25,386,15.4,2,0,0,,0,25,386,15.4,2
87,Joshua McCain\joshua-mccain-1,Idaho,Sun Belt,11,76,1162,15.3,9,1,3,3.0,0,77,1165,15.1,9
88,Demarcus Robinson*\demarcus-robinson-3,Florida,SEC,11,53,810,15.3,7,1,3,3.0,0,54,813,15.1,7
89,Dom Williams\dom-williams-1,Washington State,Pac-12,11,43,656,15.3,9,0,0,,0,43,656,15.3,9
90,Mitchell Henry*\mitchell-henry-1,Western Kentucky,CUSA,11,32,489,15.3,4,0,0,,0,32,489,15.3,4
91,Demarco Robinson\demarco-robinson-1,Kentucky,SEC,12,33,501,15.2,1,1,0,0.0,0,34,501,14.7,1
92,Tajae Sharpe\tajae-sharpe-1,Massachusetts,MAC,12,85,1281,15.1,7,3,14,4.7,0,88,1295,14.7,7
93,Devonte Boyd\devonte-boyd-1,UNLV,MWC,13,65,980,15.1,4,1,5,5.0,0,66,985,14.9,4
94,Ajalen Holley\ajalen-holley-1,Louisiana-Monroe,Sun Belt,12,57,863,15.1,7,1,9,9.0,0,58,872,15.0,7
95,Alonzo Russell*\alonzo-russell-1,Toledo,MAC,13,51,770,15.1,8,0,0,,0,51,770,15.1,8
96,Edward Pope*\edward-pope-1,Texas A&M,SEC,12,30,454,15.1,4,0,0,,0,30,454,15.1,4
97,Mitchell Juergens*\mitchell-juergens-1,Brigham Young,Ind,12,28,424,15.1,4,6,23,3.8,0,34,447,13.1,4
98,Roger Lewis*\roger-lewis-1,Bowling Green State,MAC,14,73,1094,15.0,7,1,-3,-3.0,0,74,1091,14.7,7
99,Darius Phillips*\darius-phillips-1,Western Michigan,MAC,12,32,479,15.0,2,3,37,12.3,0,35,516,14.7,2
100,Keyarris Garrett\keyarris-garrett-1,Tulsa,American,10,47,698,14.9,5,0,0,,0,47,698,14.9,5
101,Dwayne Stanford*\dwayne-stanford-1,Oregon,Pac-12,13,43,639,14.9,6,0,0,,0,43,639,14.9,6
102,Garrett Brown*\garrett-brown-2,Air Force,MWC,12,36,535,14.9,6,36,195,5.4,1,72,730,10.1,7
103,Johnny Holton*\johnny-holton-1,Cincinnati,American,13,29,431,14.9,5,0,0,,0,29,431,14.9,5
104,Donovan Harden\donovan-harden-2,Georgia State,Sun Belt,12,60,885,14.8,7,2,15,7.5,0,62,900,14.5,7
105,Michael Thomas*\michael-thomas-3,Ohio State,Big Ten,15,54,799,14.8,9,0,0,,0,54,799,14.8,9
106,Eldridge Massington*\eldridge-massington-1,UCLA,Pac-12,11,25,367,14.7,3,0,0,,0,25,367,14.7,3
107,Robert Davis\robert-davis-10,Georgia State,Sun Belt,12,50,732,14.6,2,1,3,3.0,0,51,735,14.4,2
108,Geronimo Allison*\geronimo-allison-1,Illinois,Big Ten,11,41,598,14.6,5,0,0,,0,41,598,14.6,5
109,Travis Rudolph*\travis-rudolph-1,Florida State,ACC,10,38,555,14.6,4,0,0,,0,38,555,14.6,4
110,Ian Sadler\ian-sadler-1,Texas Tech,Big 12,7,23,336,14.6,2,0,0,,0,23,336,14.6,2
111,Mario Alford*\mario-alford-1,West Virginia,Big 12,13,65,945,14.5,11,2,14,7.0,0,67,959,14.3,11
112,De'Runnya Wilson*\derunnya-wilson-1,Mississippi State,SEC,10,47,680,14.5,9,0,0,,0,47,680,14.5,9
113,Cameron Smith*\cameron-smith-2,Arizona State,Pac-12,11,41,596,14.5,6,3,25,8.3,0,44,621,14.1,6
114,William Fuller\william-fuller-2,Notre Dame,Ind,13,76,1094,14.4,15,0,0,,0,76,1094,14.4,15
115,Stephen Anderson\stephen-anderson-2,California,Pac-12,10,46,661,14.4,5,0,0,,0,46,661,14.4,5
116,Michael Thomas\michael-thomas-6,Southern Mississippi,CUSA,12,41,592,14.4,5,0,0,,0,41,592,14.4,5
117,Juwan Brescacin*\juwan-brescacin-1,Northern Illinois,MAC,11,31,445,14.4,6,0,0,,0,31,445,14.4,6
118,Josiah Price*\josiah-price-1,Michigan State,Big Ten,10,26,374,14.4,6,0,0,,0,26,374,14.4,6
119,Tyler Lockett*\tyler-lockett-1,Kansas State,Big 12,13,106,1515,14.3,11,3,17,5.7,0,109,1532,14.1,11
120,Jarrod West\jarrod-west-1,Syracuse,ACC,10,49,700,14.3,0,0,0,,0,49,700,14.3,0
121,Jared Murphy\jared-murphy-1,Miami (OH),MAC,12,42,600,14.3,4,10,28,2.8,2,52,628,12.1,6
122,J.J. Worton*\jj-worton-1,UCF,American,10,36,514,14.3,5,0,0,,0,36,514,14.3,5
123,Xavier Williams*\xavier-williams-1,Colorado State,MWC,13,30,430,14.3,3,0,0,,0,30,430,14.3,3
124,Devin Clarke\devin-clarke-1,Middle Tennessee State,CUSA,10,25,358,14.3,2,0,0,,0,25,358,14.3,2
125,Jaelen Strong*\jaelen-strong-1,Arizona State,Pac-12,12,82,1165,14.2,10,0,0,,0,82,1165,14.2,10
126,Jordan Payton*\jordan-payton-1,UCLA,Pac-12,13,67,954,14.2,7,0,0,,0,67,954,14.2,7
127,Hunter Sharp*\hunter-sharp-1,Utah State,MWC,13,66,939,14.2,7,6,28,4.7,0,72,967,13.4,7
128,Marcus Kemp\marcus-kemp-1,Hawaii,MWC,12,56,797,14.2,3,0,0,,0,56,797,14.2,3
129,Jordan Leslie*\jordan-leslie-1,Brigham Young,Ind,13,55,779,14.2,6,3,34,11.3,1,58,813,14.0,7
130,David Glidden*\david-glidden-1,Oklahoma State,Big 12,12,42,598,14.2,2,0,0,,0,42,598,14.2,2
131,Joshua Reese*\joshua-reese-1,UCF,American,12,39,552,14.2,6,4,16,4.0,0,43,568,13.2,6
132,Chris Brown\chris-brown-11,Notre Dame,Ind,13,39,548,14.1,1,1,5,5.0,0,40,553,13.8,1
133,Deon Butler*\deon-butler-2,Central Michigan,MAC,11,30,424,14.1,1,0,0,,0,30,424,14.1,1
134,Sterling Griffin*\sterling-griffin-3,Louisiana Tech,CUSA,9,29,408,14.1,2,0,0,,0,29,408,14.1,2
135,Vince Mayle\vince-mayle-1,Washington State,Pac-12,12,106,1483,14.0,9,0,0,,0,106,1483,14.0,9
136,Cayleb Jones*\cayleb-jones-2,Arizona,Pac-12,14,73,1019,14.0,9,0,0,,0,73,1019,14.0,9
137,Jakeem Grant\jakeem-grant-1,Texas Tech,Big 12,12,67,938,14.0,7,5,35,7.0,0,72,973,13.5,7
138,Alex Erickson*\alex-erickson-1,Wisconsin,Big Ten,13,55,772,14.0,3,3,1,0.3,0,58,773,13.3,3
139,Jalen Claiborne\jalen-claiborne-1,Wyoming,MWC,12,41,576,14.0,3,2,1,0.5,0,43,577,13.4,3
140,Tyler McCulloch\tyler-mcculloch-1,Colorado,Pac-12,9,30,419,14.0,2,0,0,,0,30,419,14.0,2
141,Shane Tucker\shane-tucker-1,Middle Tennessee State,CUSA,12,25,351,14.0,4,97,486,5.0,8,122,837,6.9,12
142,Rodney Adams\rodney-adams-1,South Florida,American,9,23,323,14.0,2,5,52,10.4,1,28,375,13.4,3
143,Demornay Pierson-El\demornay-pierson-el-1,Nebraska,Big Ten,13,23,321,14.0,4,5,10,2.0,0,28,331,11.8,4
144,Amari Cooper*\amari-cooper-1,Alabama,SEC,14,124,1727,13.9,16,5,23,4.6,0,129,1750,13.6,16
145,Shavarez Smith*\shavarez-smith-1,South Alabama,Sun Belt,13,54,748,13.9,8,1,-13,-13.0,0,55,735,13.4,8
146,Tevaun Smith*\tevaun-smith-1,Iowa,Big Ten,13,43,596,13.9,3,3,43,14.3,0,46,639,13.9,3
147,Hunter Henry*\hunter-henry-1,Arkansas,SEC,12,37,513,13.9,2,0,0,,0,37,513,13.9,2
148,Marquise Ricard\marquise-ricard-1,Southern Mississippi,CUSA,12,30,417,13.9,2,0,0,,0,30,417,13.9,2
149,Macgarrett Kings Jr.*\macgarrett-kings-jr-1,Michigan State,Big Ten,13,29,404,13.9,1,12,71,5.9,0,41,475,11.6,1
150,Rashad Greene*\rashad-greene-1,Florida State,ACC,14,99,1365,13.8,7,1,-2,-2.0,0,100,1363,13.6,7
151,Antwan Goodley*\antwan-goodley-1,Baylor,Big 12,10,60,830,13.8,6,8,71,8.9,0,68,901,13.3,6
152,Jalen Fitzpatrick\jalen-fitzpatrick-1,Temple,American,12,53,730,13.8,6,2,-10,-5.0,0,55,720,13.1,6
153,D'Vario Montgomery\dvario-montgomery-1,Iowa State,Big 12,9,44,605,13.8,2,1,9,9.0,0,45,614,13.6,2
154,Canaan Severin\canaan-severin-1,Virginia,ACC,12,42,578,13.8,5,0,0,,0,42,578,13.8,5
155,Mike Dudek*\mike-dudek-1,Illinois,Big Ten,13,76,1038,13.7,6,6,73,12.2,0,82,1111,13.5,6
156,Geno Lewis*\geno-lewis-1,Penn State,Big Ten,13,55,751,13.7,2,1,1,1.0,0,56,752,13.4,2
157,Bo Hines*\bo-hines-1,North Carolina State,ACC,12,45,616,13.7,1,1,3,3.0,0,46,619,13.5,1
158,Jenson Stoshak\jenson-stoshak-1,Florida Atlantic,CUSA,12,37,508,13.7,2,0,0,,0,37,508,13.7,2
159,Shaq Roland*\shaq-roland-1,South Carolina,SEC,9,26,356,13.7,4,0,0,,0,26,356,13.7,4
160,Byron Marshall*\byron-marshall-1,Oregon,Pac-12,15,74,1003,13.6,6,52,392,7.5,1,126,1395,11.1,7
161,Cody Core*\cody-core-1,Ole Miss,SEC,13,41,558,13.6,6,4,86,21.5,0,45,644,14.3,6
162,Tanner Gentry\tanner-gentry-1,Wyoming,MWC,12,32,435,13.6,2,2,3,1.5,0,34,438,12.9,2
163,Malcolm Johnson*\malcolm-johnson-2,Mississippi State,SEC,12,28,380,13.6,3,0,0,,0,28,380,13.6,3
164,Jordan Reid\jordan-reid-1,Ohio,MAC,10,24,326,13.6,1,0,0,,0,24,326,13.6,1
165,B.J. Johnson\bj-johnson-2,Georgia Southern,Sun Belt,11,23,312,13.6,3,3,29,9.7,0,26,341,13.1,3
166,Corey Robinson\corey-robinson-3,Notre Dame,Ind,12,40,539,13.5,5,0,0,,0,40,539,13.5,5
167,Steven Scheu\steven-scheu-1,Vanderbilt,SEC,12,39,525,13.5,4,0,0,,0,39,525,13.5,4
168,Bryan Holmes\bryan-holmes-1,Troy,Sun Belt,11,34,460,13.5,5,1,4,4.0,0,35,464,13.3,5
169,Curry Sexton*\curry-sexton-1,Kansas State,Big 12,13,79,1059,13.4,5,0,0,,0,79,1059,13.4,5
170,Jordan Williams\jordan-williams-3,Ball State,MAC,11,56,753,13.4,6,0,0,,0,56,753,13.4,6
171,JuJu Smith-Schuster*\juju-smith-1,USC,Pac-12,13,54,724,13.4,5,2,3,1.5,0,56,727,13.0,5
172,Tyreese Russell\tyreese-russell-1,Eastern Michigan,MAC,12,39,523,13.4,3,1,7,7.0,0,40,530,13.3,3
173,Scott Harding\scott-harding-1,Hawaii,MWC,13,34,457,13.4,3,0,0,,0,34,457,13.4,3
174,Tevin Jones*\tevin-jones-1,Memphis,American,12,33,442,13.4,3,1,0,0.0,0,34,442,13.0,3
175,Dennis Parks*\dennis-parks-1,Rice,CUSA,9,29,389,13.4,1,0,0,,0,29,389,13.4,1
176,Amir Carlisle\amir-carlisle-2,Notre Dame,Ind,12,23,309,13.4,3,7,46,6.6,0,30,355,11.8,3
177,Kevin White*\kevin-white-6,West Virginia,Big 12,13,109,1447,13.3,10,0,0,,0,109,1447,13.3,10
178,Ronald Butler*\ronald-butler-1,Utah State,MWC,14,36,478,13.3,2,6,72,12.0,0,42,550,13.1,2
179,Sam Arneson*\sam-arneson-1,Wisconsin,Big Ten,14,29,387,13.3,4,0,0,,0,29,387,13.3,4
180,Alan Cross*\alan-cross-2,Memphis,American,12,28,373,13.3,4,1,1,1.0,1,29,374,12.9,5
181,David Grinnage*\david-grinnage-1,North Carolina State,ACC,11,27,358,13.3,5,0,0,,0,27,358,13.3,5
182,Joel German*\joel-german-1,Western Kentucky,CUSA,13,27,358,13.3,4,0,0,,0,27,358,13.3,4
183,Cameron Dickerson\cameron-dickerson-1,Northwestern,Big Ten,9,24,318,13.3,1,0,0,,0,24,318,13.3,1
184,Laquon Treadwell*\laquon-treadwell-1,Ole Miss,SEC,9,48,632,13.2,5,2,-7,-3.5,0,50,625,12.5,5
185,Dominic Rufran\dominic-rufran-1,Wyoming,MWC,12,45,596,13.2,0,6,15,2.5,0,51,611,12.0,0
186,Allen Lazard\allen-lazard-1,Iowa State,Big 12,12,45,593,13.2,3,0,0,,0,45,593,13.2,3
187,Markese Triplett\markese-triplett-1,Southern Mississippi,CUSA,12,40,529,13.2,1,0,0,,0,40,529,13.2,1
188,Marcus Henry\marcus-henry-2,Middle Tennessee State,CUSA,11,40,527,13.2,4,0,0,,0,40,527,13.2,4
189,Josh Robinson*\josh-robinson-2,Mississippi State,SEC,13,28,370,13.2,1,190,1203,6.3,11,218,1573,7.2,12
190,Jalin Marshall*\jalin-marshall-1,Ohio State,Big Ten,15,38,499,13.1,6,25,145,5.8,1,63,644,10.2,7
191,Amara Darboh\amara-darboh-1,Michigan,Big Ten,11,36,473,13.1,2,0,0,,0,36,473,13.1,2
192,Gehrig Dieter*\gehrig-dieter-1,Bowling Green State,MAC,8,35,460,13.1,1,0,0,,0,35,460,13.1,1
193,Aaron Peck*\aaron-peck-1,Fresno State,MWC,12,32,419,13.1,3,0,0,,0,32,419,13.1,3
194,Trey Griffey*\trey-griffey-1,Arizona,Pac-12,13,31,405,13.1,1,0,0,,0,31,405,13.1,1
195,Bra'Lon Cherry*\bralon-cherry-1,North Carolina State,ACC,11,27,354,13.1,3,6,40,6.7,2,33,394,11.9,5
196,Bud Sasser*\bud-sasser-1,Missouri,SEC,14,77,1003,13.0,12,0,0,,0,77,1003,13.0,12
197,Trent Taylor*\trent-taylor-2,Louisiana Tech,CUSA,14,64,834,13.0,9,0,0,,0,64,834,13.0,9
198,Kenny Lawler\kenny-lawler-1,California,Pac-12,11,54,701,13.0,9,0,0,,0,54,701,13.0,9
199,Austin Hill*\austin-hill-1,Arizona,Pac-12,14,49,635,13.0,4,0,0,,0,49,635,13.0,4
200,Jimmay Mundine\jimmay-mundine-1,Kansas,Big 12,11,45,584,13.0,3,0,0,,0,45,584,13.0,3
201,Keon Hatcher*\keon-hatcher-1,Arkansas,SEC,13,43,558,13.0,6,5,112,22.4,1,48,670,14.0,7
202,Jerrel Brown\jerrel-brown-1,New Mexico State,Sun Belt,10,34,442,13.0,2,0,0,,0,34,442,13.0,2
203,Westlee Tonga*\westlee-tonga-1,Utah,Pac-12,11,30,391,13.0,4,0,0,,0,30,391,13.0,4
204,Chris Godwin*\chris-godwin-1,Penn State,Big Ten,13,26,338,13.0,2,2,1,0.5,0,28,339,12.1,2
205,Alex Welch\alex-welch-1,Miami (OH),MAC,8,24,312,13.0,2,0,0,,0,24,312,13.0,2
206,Tres Houston*\tres-houston-1,Arkansas State,Sun Belt,13,53,685,12.9,4,0,0,,0,53,685,12.9,4
207,Nick O'Leary*\nick-oleary-1,Florida State,ACC,13,48,618,12.9,6,0,0,,1,48,618,12.9,7
208,Hasaan Henderson*\hasaan-henderson-1,Nevada,MWC,9,45,579,12.9,4,0,0,,0,45,579,12.9,4
209,Justyn Shackleford\justyn-shackleford-1,Tulane,American,11,36,465,12.9,2,0,0,,0,36,465,12.9,2
210,Marken Michel\marken-michel-1,Massachusetts,MAC,12,30,386,12.9,1,19,115,6.1,2,49,501,10.2,3
211,Stefon Diggs*\stefon-diggs-1,Maryland,Big Ten,10,62,792,12.8,5,5,28,5.6,0,67,820,12.2,5
212,Kenneth Dixon*\kenneth-dixon-1,Louisiana Tech,CUSA,14,30,385,12.8,6,253,1299,5.1,22,283,1684,6.0,28
213,Deshon Foxx\deshon-foxx-1,Connecticut,American,12,30,384,12.8,1,23,203,8.8,1,53,587,11.1,2
214,Josh Bordner*\josh-bordner-1,Boston College,ACC,13,27,346,12.8,3,0,0,,0,27,346,12.8,3
215,Alex Deleon\alex-deleon-1,Florida Atlantic,CUSA,10,23,295,12.8,5,0,0,,0,23,295,12.8,5
216,Artavis Scott*\artavis-scott-1,Clemson,ACC,12,76,965,12.7,8,6,18,3.0,0,82,983,12.0,8
217,Isaiah Ford*\isaiah-ford-1,Virginia Tech,ACC,13,56,709,12.7,6,4,0,0.0,0,60,709,11.8,6
218,David Washington\david-washington-4,Old Dominion,CUSA,12,47,599,12.7,4,1,0,0.0,0,48,599,12.5,4
219,Speedy Noil*\speedy-noil-1,Texas A&M,SEC,12,46,583,12.7,5,1,10,10.0,0,47,593,12.6,5
220,Danny Woodson Jr.*\danny-woodson-jr-1,South Alabama,Sun Belt,12,30,382,12.7,4,0,0,,0,30,382,12.7,4
221,Nelson Agholor*\nelson-agholor-1,USC,Pac-12,13,104,1313,12.6,12,4,3,0.8,0,108,1316,12.2,12
222,Mitch Mathews*\mitch-mathews-1,Brigham Young,Ind,13,73,922,12.6,9,0,0,,0,73,922,12.6,9
223,Bradley Marquez\bradley-marquez-1,Texas Tech,Big 12,12,65,821,12.6,10,0,0,,0,65,821,12.6,10
224,Zach Pascal\zach-pascal-1,Old Dominion,CUSA,12,59,743,12.6,7,0,0,,0,59,743,12.6,7
225,Shane Wynn\shane-wynn-1,Indiana,Big Ten,12,56,708,12.6,3,4,138,34.5,2,60,846,14.1,5
226,Deandrew White*\deandrew-white-1,Alabama,SEC,10,40,504,12.6,4,2,-4,-2.0,0,42,500,11.9,4
227,George Farmer*\george-farmer-2,USC,Pac-12,10,25,314,12.6,4,2,2,1.0,0,27,316,11.7,4
228,Isiah Myers\isiah-myers-1,Washington State,Pac-12,12,78,972,12.5,12,0,0,,0,78,972,12.5,12
229,Chris Humphrey\chris-humphrey-1,Kent State,MAC,11,51,635,12.5,5,0,0,,0,51,635,12.5,5
230,Jesus Wilson*\jesus-wilson-1,Florida State,ACC,13,42,527,12.5,4,0,0,,0,42,527,12.5,4
231,Austin Hooper*\austin-hooper-1,Stanford,Pac-12,12,40,499,12.5,2,0,0,,0,40,499,12.5,2
232,Cam Phillips*\cam-phillips-1,Virginia Tech,ACC,10,40,498,12.5,3,5,65,13.0,0,45,563,12.5,3
233,Janarion Grant*\janarion-grant-1,Rutgers,Big Ten,11,25,312,12.5,0,5,52,10.4,0,30,364,12.1,0
234,Tommy Shuler*\tommy-shuler-1,Marshall,CUSA,14,92,1138,12.4,9,0,0,,0,92,1138,12.4,9
235,Corey Jones*\corey-jones-3,Toledo,MAC,13,68,842,12.4,5,8,88,11.0,0,76,930,12.2,5
236,Ryan Switzer*\ryan-switzer-1,North Carolina,ACC,13,61,757,12.4,4,8,29,3.6,0,69,786,11.4,4
237,Antwane Grant*\antwane-grant-1,Western Kentucky,CUSA,10,41,509,12.4,6,0,0,,0,41,509,12.4,6
238,James Butler*\james-butler-2,Louisiana,Sun Belt,11,38,470,12.4,0,0,0,,0,38,470,12.4,0
239,Sebastian Smith\sebastian-smith-1,Ohio,MAC,10,31,385,12.4,2,0,0,,0,31,385,12.4,2
240,Darius White*\darius-white-1,Missouri,SEC,10,30,372,12.4,4,0,0,,0,30,372,12.4,4
241,Justin Hardy*\justin-hardy-1,East Carolina,American,13,121,1494,12.3,10,1,7,7.0,1,122,1501,12.3,11
242,Jamison Crowder*\jamison-crowder-1,Duke,ACC,13,85,1044,12.3,6,2,9,4.5,0,87,1053,12.1,6
243,Carlos Harris\carlos-harris-1,North Texas,CUSA,12,70,863,12.3,3,9,92,10.2,1,79,955,12.1,4
244,Ronnie Moore*\ronnie-moore-3,Bowling Green State,MAC,14,56,690,12.3,5,21,129,6.1,2,77,819,10.6,7
245,Keiwone Malone*\keiwone-malone-1,Memphis,American,13,45,555,12.3,4,4,63,15.8,0,49,618,12.6,4
246,Joel Ruiz\joel-ruiz-1,Georgia State,Sun Belt,10,39,478,12.3,3,0,0,,0,39,478,12.3,3
247,Tim Crawley\tim-crawley-1,San Jose State,MWC,11,35,430,12.3,1,32,107,3.3,1,67,537,8.0,2
248,Aaron Burbridge*\aaron-burbridge-1,Michigan State,Big Ten,13,29,358,12.3,1,8,39,4.9,0,37,397,10.7,1
249,Germone Hopper*\germone-hopper-1,Clemson,ACC,10,27,331,12.3,3,1,0,0.0,0,28,331,11.8,3
250,Josh Harper*\josh-harper-1,Fresno State,MWC,14,90,1097,12.2,7,2,-4,-2.0,0,92,1093,11.9,7
251,Kevonn Mabon\kevonn-mabon-1,Ball State,MAC,12,59,717,12.2,5,5,54,10.8,1,64,771,12.0,6
252,Chris Harper\chris-harper-3,California,Pac-12,12,52,634,12.2,6,5,17,3.4,0,57,651,11.4,6
253,Jordan Thompson*\jordan-thompson-2,West Virginia,Big 12,13,49,598,12.2,2,6,37,6.2,0,55,635,11.5,2
254,Kaelin Clay*\kaelin-clay-1,Utah,Pac-12,13,43,523,12.2,4,4,4,1.0,0,47,527,11.2,4
255,Paul Turner*\paul-turner-3,Louisiana Tech,CUSA,12,42,514,12.2,4,0,0,,0,42,514,12.2,4
256,Durron Neal*\durron-neal-1,Oklahoma,Big 12,12,42,513,12.2,3,2,19,9.5,0,44,532,12.1,3
257,Maika Mataele\maika-mataele-1,UNLV,MWC,13,29,355,12.2,1,0,0,,0,29,355,12.2,1
258,Dan Crimmins*\dan-crimmins-1,Boston College,ACC,10,25,305,12.2,0,0,0,,0,25,305,12.2,0
259,Keevan Lucas\keevan-lucas-1,Tulsa,American,12,101,1219,12.1,11,7,66,9.4,0,108,1285,11.9,11
260,J.D. McKissic*\jd-mckissic-1,Arkansas State,Sun Belt,10,52,629,12.1,0,9,115,12.8,1,61,744,12.2,1
261,Quan Bray*\quan-bray-1,Auburn,SEC,13,39,471,12.1,4,9,74,8.2,1,48,545,11.4,5
262,Teldrick Morgan\teldrick-morgan-1,New Mexico State,Sun Belt,11,75,903,12.0,7,2,16,8.0,0,77,919,11.9,7
263,Jared Dangerfield*\jared-dangerfield-1,Western Kentucky,CUSA,13,69,825,12.0,11,0,0,,0,69,825,12.0,11
264,Devon Hughes\devon-hughes-1,Buffalo,MAC,10,43,515,12.0,7,0,0,,0,43,515,12.0,7
265,Nick Jones*\nick-jones-2,South Carolina,SEC,13,42,504,12.0,5,0,0,,0,42,504,12.0,5
266,Gerald Christian*\gerald-christian-1,Louisville,ACC,13,32,384,12.0,5,0,0,,0,32,384,12.0,5
267,Ty Slanina*\ty-slanina-1,Texas Christian,Big 12,11,32,383,12.0,2,0,0,,0,32,383,12.0,2
268,Andrew Pratt\andrew-pratt-1,Akron,MAC,9,27,324,12.0,0,0,0,,0,27,324,12.0,0
269,Quincy Adeboyejo*\quincy-adeboyejo-1,Ole Miss,SEC,9,26,313,12.0,2,1,-1,-1.0,0,27,312,11.6,2
270,Zach Wright*\zach-wright-1,Rice,CUSA,9,25,299,12.0,3,0,0,,0,25,299,12.0,3
271,Willie McNeal*\willie-mcneal-1,Western Kentucky,CUSA,12,56,666,11.9,8,0,0,,0,56,666,11.9,8
272,Issac Blakeney*\issac-blakeney-1,Duke,ACC,13,47,559,11.9,7,0,0,,0,47,559,11.9,7
273,Ryan Timmons\ryan-timmons-1,Kentucky,SEC,11,45,536,11.9,2,5,-9,-1.8,0,50,527,10.5,2
274,Joshua Atkinson\joshua-atkinson-1,Tulsa,American,12,35,416,11.9,0,0,0,,0,35,416,11.9,0
275,Jameon Lewis*\jameon-lewis-1,Mississippi State,SEC,9,32,380,11.9,2,7,56,8.0,0,39,436,11.2,2
276,Jabari Carr\jabari-carr-1,San Jose State,MWC,9,30,356,11.9,3,0,0,,0,30,356,11.9,3
277,Bishop Louie\bishop-louie-1,Tulsa,American,11,23,274,11.9,1,7,100,14.3,1,30,374,12.5,2
278,Ryan Burbrink*\ryan-burbrink-1,Bowling Green State,MAC,14,64,758,11.8,3,1,6,6.0,0,65,764,11.8,3
279,Devin Funchess\devin-funchess-1,Michigan,Big Ten,11,62,733,11.8,4,2,-11,-5.5,0,64,722,11.3,4
280,Geremy Davis\geremy-davis-1,Connecticut,American,10,44,521,11.8,3,0,0,,0,44,521,11.8,3
281,Gregory Hogan\gregory-hogan-1,New Mexico State,Sun Belt,10,28,331,11.8,3,0,0,,0,28,331,11.8,3
282,Deontay Greenberry*\deontay-greenberry-1,Houston,American,13,72,841,11.7,6,0,0,,0,72,841,11.7,6
283,River Cracraft\river-cracraft-1,Washington State,Pac-12,9,66,771,11.7,8,0,0,,0,66,771,11.7,8
284,Jerico Richardson*\jerico-richardson-1,Nevada,MWC,11,56,655,11.7,3,0,4,,1,56,659,11.8,4
285,Bucky Hodges*\bucky-hodges-1,Virginia Tech,ACC,13,45,526,11.7,7,7,20,2.9,0,52,546,10.5,7
286,Eli Rogers*\eli-rogers-1,Louisville,ACC,13,45,525,11.7,3,0,0,,0,45,525,11.7,3
287,Jake Roh*\jake-roh-1,Boise State,MWC,14,35,408,11.7,2,0,0,,0,35,408,11.7,2
288,Hunter Lee*\hunter-lee-1,Louisiana Tech,CUSA,11,29,338,11.7,3,5,18,3.6,0,34,356,10.5,3
289,Mike McFarland\mike-mcfarland-1,South Florida,American,10,27,315,11.7,0,0,0,,0,27,315,11.7,0
290,Noel Thomas\noel-thomas-1,Connecticut,American,8,26,305,11.7,4,0,0,,0,26,305,11.7,4
291,Kai De La Cruz*\kai-de-la-cruz-1,Louisville,ACC,11,26,303,11.7,2,0,0,,0,26,303,11.7,2
292,Maudrecus Humphrey\maudrecus-humphrey-1,UAB,CUSA,11,24,281,11.7,0,2,1,0.5,0,26,282,10.8,0
293,Deonte Welch\deonte-welch-1,South Florida,American,11,23,269,11.7,0,2,-6,-3.0,0,25,263,10.5,0
294,Daniel Braverman*\daniel-braverman-1,Western Michigan,MAC,13,86,997,11.6,6,6,58,9.7,1,92,1055,11.5,7
295,Jonnu Smith\jonnu-smith-1,Florida International,CUSA,12,61,710,11.6,8,0,0,,0,61,710,11.6,8
296,Marcus Johnson*\marcus-johnson-3,Texas,Big 12,13,27,313,11.6,1,0,0,,0,27,313,11.6,1
297,Darius Terrell\darius-terrell-1,North Texas,CUSA,11,26,301,11.6,0,0,0,,0,26,301,11.6,0
298,Shaq Washington*\shaq-washington-1,Cincinnati,American,13,66,761,11.5,4,8,23,2.9,0,74,784,10.6,4
299,Malcome Kennedy*\malcome-kennedy-1,Texas A&M,SEC,11,53,611,11.5,6,1,-3,-3.0,0,54,608,11.3,6
300,Simms McElfresh\simms-mcelfresh-1,Appalachian State,Sun Belt,12,42,484,11.5,5,4,20,5.0,2,46,504,11.0,7
301,Quinshad Davis*\quinshad-davis-1,North Carolina,ACC,12,41,470,11.5,6,0,0,,0,41,470,11.5,6
302,Brandon Smith\brandon-smith-7,Texas State,Sun Belt,11,36,414,11.5,1,0,0,,0,36,414,11.5,1
303,Mike Davis*\mike-davis-9,South Carolina,SEC,13,32,368,11.5,2,199,982,4.9,9,231,1350,5.8,11
304,Ben Lewis\ben-lewis-2,Syracuse,ACC,9,24,275,11.5,1,0,0,,0,24,275,11.5,1
305,Quinton Pedroza\quinton-pedroza-2,Hawaii,MWC,11,59,674,11.4,3,1,9,9.0,0,60,683,11.4,3
306,Pig Howard*\pig-howard-1,Tennessee,SEC,13,54,618,11.4,1,15,96,6.4,2,69,714,10.3,3
307,Eric Frohnapfel*\eric-frohnapfel-1,Marshall,CUSA,13,37,420,11.4,5,0,0,,0,37,420,11.4,5
308,Tyler Baker\tyler-baker-1,Washington State,Pac-12,5,27,308,11.4,2,0,0,,0,27,308,11.4,2
309,Nelson Spruce\nelson-spruce-1,Colorado,Pac-12,12,106,1198,11.3,12,1,2,2.0,0,107,1200,11.2,12
310,Rashon Ceaser\rashon-ceaser-1,Louisiana-Monroe,Sun Belt,12,77,872,11.3,3,0,0,,0,77,872,11.3,3
311,Deon Long*\deon-long-1,Maryland,Big Ten,13,51,575,11.3,2,1,9,9.0,0,52,584,11.2,2
312,Bryce Treggs\bryce-treggs-1,California,Pac-12,12,52,583,11.2,6,1,0,0.0,0,53,583,11.0,6
313,Javorius Allen*\javorius-allen-1,USC,Pac-12,13,41,458,11.2,1,276,1489,5.4,11,317,1947,6.1,12
314,Victor Bolden\victor-bolden-1,Oregon State,Pac-12,11,72,798,11.1,2,19,118,6.2,0,91,916,10.1,2
315,D.J. Foster*\dj-foster-1,Arizona State,Pac-12,13,62,688,11.1,3,194,1081,5.6,9,256,1769,6.9,12
316,Duke Johnson*\duke-johnson-1,Miami (FL),ACC,13,38,421,11.1,3,242,1652,6.8,10,280,2073,7.4,13
317,DaeSean Hamilton*\daesean-hamilton-1,Penn State,Big Ten,13,82,899,11.0,2,8,32,4.0,0,90,931,10.3,2
318,Kenzee Jackson\kenzee-jackson-1,Louisiana-Monroe,Sun Belt,12,79,866,11.0,4,0,0,,0,79,866,11.0,4
319,Reginald Davis\reginald-davis-1,Texas Tech,Big 12,10,29,318,11.0,5,0,0,,0,29,318,11.0,5
320,Richard Montgomery\richard-montgomery-1,Idaho,Sun Belt,10,50,543,10.9,1,13,56,4.3,2,63,599,9.5,3
321,L.T. Smith\lt-smith-1,Akron,MAC,12,45,489,10.9,3,0,0,,0,45,489,10.9,3
322,Michael Bennett*\michael-bennett-4,Georgia,SEC,11,37,404,10.9,4,0,0,,0,37,404,10.9,4
323,Jake Duzey*\jake-duzey-1,Iowa,Big Ten,11,36,392,10.9,3,0,0,,0,36,392,10.9,3
324,Deandre Washington\deandre-washington-1,Texas Tech,Big 12,12,30,328,10.9,2,188,1103,5.9,2,218,1431,6.6,4
325,Mose Frazier*\mose-frazier-1,Memphis,American,13,47,506,10.8,3,11,68,6.2,0,58,574,9.9,3
326,Bug Howard*\bug-howard-1,North Carolina,ACC,12,42,455,10.8,2,0,0,,0,42,455,10.8,2
327,Rickey Galvin\rickey-galvin-1,Washington State,Pac-12,11,37,400,10.8,3,0,0,,0,37,400,10.8,3
328,Aregeros Turner*\aregeros-turner-1,Northern Illinois,MAC,14,37,398,10.8,2,13,38,2.9,2,50,436,8.7,4
329,Daniel Lasco\daniel-lasco-1,California,Pac-12,12,33,356,10.8,2,210,1115,5.3,12,243,1471,6.1,14
330,Adam Shapiro\adam-shapiro-1,New Mexico State,Sun Belt,10,25,271,10.8,1,1,-26,-26.0,0,26,245,9.4,1
331,Kris White\kris-white-1,Kent State,MAC,9,25,270,10.8,0,0,0,,0,25,270,10.8,0
332,Casey Pierce\casey-pierce-1,Kent State,MAC,11,60,641,10.7,6,0,0,,0,60,641,10.7,6
333,Jay Ajayi*\jay-ajayi-1,Boise State,MWC,14,50,535,10.7,4,347,1823,5.3,28,397,2358,5.9,32
334,Nick Harwell\nick-harwell-1,Kansas,Big 12,12,44,470,10.7,5,2,7,3.5,0,46,477,10.4,5
335,Hansel Wilson\hansel-wilson-1,San Jose State,MWC,12,39,417,10.7,3,1,-4,-4.0,0,40,413,10.3,3
336,Connor Hamlett\connor-hamlett-1,Oregon State,Pac-12,12,32,342,10.7,2,0,0,,0,32,342,10.7,2
337,Anthony Rice*\anthony-rice-2,Central Michigan,MAC,11,30,321,10.7,1,1,12,12.0,0,31,333,10.7,1
338,Marquez North*\marquez-north-1,Tennessee,SEC,8,30,320,10.7,4,0,0,,0,30,320,10.7,4
339,Ben Ijah\ben-ijah-1,Texas State,Sun Belt,12,27,289,10.7,3,0,0,,0,27,289,10.7,3
340,Paul Lasike*\paul-lasike-1,Brigham Young,Ind,13,25,267,10.7,2,79,364,4.6,7,104,631,6.1,9
341,Zach D'Orazio\zach-dorazio-1,Akron,MAC,12,62,658,10.6,1,1,3,3.0,0,63,661,10.5,1
342,Jared Crump\jared-crump-1,Wake Forest,ACC,12,32,339,10.6,1,1,2,2.0,0,33,341,10.3,1
343,Ben Koyack\ben-koyack-1,Notre Dame,Ind,13,30,317,10.6,2,0,0,,0,30,317,10.6,2
344,Tyler Ervin\tyler-ervin-1,San Jose State,MWC,12,29,306,10.6,1,158,888,5.6,4,187,1194,6.4,5
345,Kyle Prater\kyle-prater-1,Northwestern,Big Ten,11,51,535,10.5,2,0,0,,0,51,535,10.5,2
346,Kenneth Scott*\kenneth-scott-1,Utah,Pac-12,12,48,506,10.5,4,0,0,,0,48,506,10.5,4
347,Ed'Marques Batties\edmarques-batties-1,Middle Tennessee State,CUSA,12,45,474,10.5,3,2,28,14.0,0,47,502,10.7,3
348,Greg Watson*\greg-watson-1,Fresno State,MWC,11,35,369,10.5,5,2,13,6.5,0,37,382,10.3,5
349,Wendell Smallwood*\wendell-smallwood-1,West Virginia,Big 12,13,31,326,10.5,0,148,722,4.9,2,179,1048,5.9,2
350,Melvin Vaughn\melvin-vaughn-1,Old Dominion,CUSA,8,30,315,10.5,3,0,0,,0,30,315,10.5,3
351,Chris Shillings\chris-shillings-1,Ball State,MAC,12,28,293,10.5,1,0,0,,0,28,293,10.5,1
352,Elijah McGuire*\elijah-mcguire-1,Louisiana,Sun Belt,13,45,468,10.4,2,166,1264,7.6,14,211,1732,8.2,16
353,Jesse James*\jesse-james-1,Penn State,Big Ten,13,38,396,10.4,3,0,0,,0,38,396,10.4,3
354,Joseph Matthews\joseph-matthews-1,New Mexico State,Sun Belt,12,37,386,10.4,4,0,0,,0,37,386,10.4,4
355,Max McCaffrey*\max-mccaffrey-1,Duke,ACC,12,37,385,10.4,3,0,0,,0,37,385,10.4,3
356,Al-Damion Riles*\al-damion-riles-1,Louisiana,Sun Belt,12,34,354,10.4,1,3,5,1.7,0,37,359,9.7,1
357,Jaydon Mickens*\jaydon-mickens-1,Washington,Pac-12,14,60,617,10.3,4,17,103,6.1,2,77,720,9.4,6
358,Lynquez Blair\lynquez-blair-1,Georgia State,Sun Belt,10,52,538,10.3,6,1,-17,-17.0,0,53,521,9.8,6
359,E.J. Scott\ej-scott-1,Wake Forest,ACC,12,50,513,10.3,4,6,39,6.5,1,56,552,9.9,5
360,Von Pearson*\von-pearson-1,Tennessee,SEC,11,38,393,10.3,5,8,27,3.4,0,46,420,9.1,5
361,Justin Podrabsky\justin-podrabsky-1,Idaho,Sun Belt,11,37,380,10.3,1,0,0,,0,37,380,10.3,1
362,Davon Grayson*\davon-grayson-1,East Carolina,American,10,25,257,10.3,0,0,0,,0,25,257,10.3,0
363,Zay Jones*\isaiah-jones-2,East Carolina,American,13,81,830,10.2,5,0,0,,0,81,830,10.2,5
364,Rannell Hall*\rannell-hall-1,UCF,American,10,49,500,10.2,0,25,129,5.2,1,74,629,8.5,1
365,Max Morrison*\max-morrison-1,Cincinnati,American,12,45,458,10.2,4,0,0,,0,45,458,10.2,4
366,Kennard Backman\kennard-backman-1,UAB,CUSA,12,39,399,10.2,3,0,0,,0,39,399,10.2,3
367,Demarcus Ayers*\demarcus-ayers-1,Houston,American,13,33,335,10.2,2,2,4,2.0,0,35,339,9.7,2
368,Malik Turner*\malik-turner-1,Illinois,Big Ten,8,25,256,10.2,1,0,0,,0,25,256,10.2,1
369,Dan Vitale\dan-vitale-1,Northwestern,Big Ten,11,40,402,10.1,2,1,0,0.0,0,41,402,9.8,2
370,David Porter*\david-porter-1,Texas Christian,Big 12,12,39,392,10.1,3,0,0,,0,39,392,10.1,3
371,D.D. Goodson\dd-goodson-1,Colorado,Pac-12,9,38,382,10.1,2,1,7,7.0,0,39,389,10.0,2
372,Boone Niederhofer*\boone-niederhofer-1,Texas A&M,SEC,8,29,293,10.1,1,0,0,,0,29,293,10.1,1
373,Maurice Harris\maurice-harris-3,California,Pac-12,9,25,252,10.1,2,0,0,,0,25,252,10.1,2
374,Matt James\matt-james-1,Wake Forest,ACC,9,40,401,10.0,0,0,0,,0,40,401,10.0,0
375,Matt Dayes*\matt-dayes-1,North Carolina State,ACC,13,32,321,10.0,5,104,573,5.5,8,136,894,6.6,13
376,Jacob Martinez\jacob-martinez-1,Buffalo,MAC,11,28,280,10.0,3,2,1,0.5,0,30,281,9.4,3
377,Ty Montgomery*\ty-montgomery-1,Stanford,Pac-12,11,61,604,9.9,3,23,144,6.3,1,84,748,8.9,4
378,Kevonte Martin-Manley*\kevonte-martin-manley-1,Iowa,Big Ten,13,52,517,9.9,2,0,0,,0,52,517,9.9,2
379,Bruce Natson*\bruce-natson-1,Utah State,MWC,13,51,504,9.9,2,50,498,10.0,3,101,1002,9.9,5
380,Jack Tabb*\jack-tabb-1,North Carolina,ACC,11,26,257,9.9,3,0,0,,0,26,257,9.9,3
381,Malcolm Lewis*\malcolm-lewis-2,Miami (FL),ACC,11,25,248,9.9,1,0,0,,0,25,248,9.9,1
382,Jaxon Shipley*\jaxon-shipley-1,Texas,Big 12,12,59,577,9.8,1,0,0,,0,59,577,9.8,1
383,Cam Serigne\cam-serigne-1,Wake Forest,ACC,12,54,531,9.8,5,0,0,,0,54,531,9.8,5
384,Bradley Miller\bradley-miller-1,Texas State,Sun Belt,12,44,431,9.8,1,0,0,,0,44,431,9.8,1
385,Aaron Jones*\aaron-jones-6,UTEP,CUSA,12,30,293,9.8,3,242,1321,5.5,11,272,1614,5.9,14
386,Casey Martin\casey-martin-1,Southern Mississippi,CUSA,11,55,531,9.7,2,0,0,,0,55,531,9.7,2
387,Shay Fields\shay-fields-1,Colorado,Pac-12,12,50,486,9.7,4,4,24,6.0,1,54,510,9.4,5
388,Chandler Worthy\chandler-worthy-1,Troy,Sun Belt,12,44,428,9.7,3,12,55,4.6,0,56,483,8.6,3
389,Latevius Rayford\latevius-rayford-1,Vanderbilt,SEC,11,36,350,9.7,1,1,8,8.0,0,37,358,9.7,1
390,Ernest Calhoun\ernest-calhoun-1,Kent State,MAC,11,33,319,9.7,1,6,-20,-3.3,0,39,299,7.7,1
391,C.J. Best\cj-best-1,Texas State,Sun Belt,12,37,355,9.6,2,36,326,9.1,1,73,681,9.3,3
392,Roderick Proctor*\roderick-proctor-1,Memphis,American,11,27,259,9.6,1,7,-16,-2.3,0,34,243,7.1,1
393,Ricky Seals-Jones*\ricky-seals-jones-1,Texas A&M,SEC,11,49,465,9.5,4,0,0,,0,49,465,9.5,4
394,Teddy Veal\teddy-veal-1,Tulane,American,12,40,381,9.5,1,1,24,24.0,1,41,405,9.9,2
395,Taylor Barnhill\taylor-barnhill-1,UNLV,MWC,10,29,275,9.5,2,0,0,,0,29,275,9.5,2
396,Michiah Quick*\michiah-quick-1,Oklahoma,Big 12,8,25,237,9.5,1,4,6,1.5,0,29,243,8.4,1
397,Dustin Creel\dustin-creel-1,Eastern Michigan,MAC,8,24,228,9.5,0,0,0,,0,24,228,9.5,0
398,Jereme Jones*\jereme-jones-1,South Alabama,Sun Belt,13,36,338,9.4,2,0,0,,0,36,338,9.4,2
399,Lucky Whitehead\lucky-whitehead-1,Florida Atlantic,CUSA,12,76,706,9.3,6,21,210,10.0,1,97,916,9.4,7
400,Richy Turner*\richy-turner-1,Nevada,MWC,13,63,587,9.3,4,1,-4,-4.0,0,64,583,9.1,4
401,Leon Allen*\leon-allen-1,Western Kentucky,CUSA,13,51,476,9.3,3,272,1542,5.7,13,323,2018,6.2,16
402,Deon Watson\deon-watson-1,Idaho,Sun Belt,10,37,343,9.3,1,0,0,,0,37,343,9.3,1
403,Steven Walker*\steven-walker-1,Colorado State,MWC,12,30,279,9.3,4,0,0,,0,30,279,9.3,4
404,Bryce Bobo\bryce-bobo-1,Colorado,Pac-12,10,23,215,9.3,3,1,-3,-3.0,0,24,212,8.8,3
405,Tony Jones\tony-jones-1,Northwestern,Big Ten,10,35,323,9.2,1,3,17,5.7,0,38,340,8.9,1
406,Levi Norwood*\levi-norwood-1,Baylor,Big 12,10,35,319,9.1,2,1,4,4.0,0,36,323,9.0,2
407,Tyreek Hill*\tyreek-hill-1,Oklahoma State,Big 12,12,31,281,9.1,1,102,534,5.2,1,133,815,6.1,2
408,Karlos Williams*\karlos-williams-1,Florida State,ACC,12,29,265,9.1,1,150,689,4.6,11,179,954,5.3,12
409,Fransohn Bickley\fransohn-bickley-1,Akron,MAC,8,29,264,9.1,0,1,-5,-5.0,0,30,259,8.6,0
410,Robert Lewis\robert-lewis-7,Washington State,Pac-12,11,41,370,9.0,2,0,0,,0,41,370,9.0,2
411,Wayne Beadle*\wayne-beadle-1,Houston,American,9,27,242,9.0,0,0,0,,0,27,242,9.0,0
412,Tyler Winston\tyler-winston-1,San Jose State,MWC,12,78,694,8.9,5,0,0,,0,78,694,8.9,5
413,Landon Smith\landon-smith-2,Ohio,MAC,7,24,213,8.9,2,1,8,8.0,0,25,221,8.8,2
414,Jarred Gipson*\jarred-gipson-1,Nevada,MWC,12,33,291,8.8,4,0,0,,0,33,291,8.8,4
415,Gabe Fuselier*\gabe-fuselier-1,Louisiana,Sun Belt,10,30,264,8.8,2,0,0,,0,30,264,8.8,2
416,Aaron Grubb\aaron-grubb-1,UTSA,CUSA,10,23,202,8.8,0,2,2,1.0,0,25,204,8.2,0
417,Shane Williams-Rhodes*\shane-williams-rhodes-1,Boise State,MWC,13,68,585,8.6,7,15,179,11.9,0,83,764,9.2,7
418,Robert Lowe\robert-lowe-2,Texas State,Sun Belt,11,24,207,8.6,1,185,1091,5.9,12,209,1298,6.2,13
419,Josh Ferguson*\josh-ferguson-3,Illinois,Big Ten,13,50,427,8.5,2,146,735,5.0,8,196,1162,5.9,10
420,E.J. Bibbs\ej-bibbs-1,Iowa State,Big 12,10,45,382,8.5,8,0,0,,0,45,382,8.5,8
421,Autrey Golden*\autrey-golden-1,UTEP,CUSA,13,31,263,8.5,2,15,101,6.7,0,46,364,7.9,2
422,Willie Byrn*\willie-byrn-1,Virginia Tech,ACC,12,47,388,8.3,0,0,0,,0,47,388,8.3,0
423,Breon Allen*\breon-allen-1,East Carolina,American,12,35,289,8.3,1,134,869,6.5,8,169,1158,6.9,9
424,Damon Bullock*\damon-bullock-1,Iowa,Big Ten,10,32,265,8.3,0,27,74,2.7,0,59,339,5.7,0
425,Miles Shuler\miles-shuler-1,Northwestern,Big Ten,8,23,190,8.3,0,6,24,4.0,1,29,214,7.4,1
426,Joshua Bowen\joshua-bowen-1,New Mexico State,Sun Belt,10,41,336,8.2,1,0,0,,0,41,336,8.2,1
427,Aaron Wimberly\aaron-wimberly-1,Iowa State,Big 12,11,27,222,8.2,1,147,642,4.4,7,174,864,5.0,8
428,Deion Sanders Jr.\deion-sanders-jr-1,SMU,American,9,23,188,8.2,0,0,0,,0,23,188,8.2,0
429,Dontrell Hilliard\dontrell-hilliard-1,Tulane,American,12,30,244,8.1,1,97,452,4.7,3,127,696,5.5,4
430,Jahwan Edwards\jahwan-edwards-1,Ball State,MAC,12,29,236,8.1,0,262,1252,4.8,12,291,1488,5.1,12
431,John Christopher\john-christopher-1,Temple,American,9,24,194,8.1,0,0,0,,0,24,194,8.1,0
432,Justin Sinz\justin-sinz-1,Purdue,Big Ten,12,32,257,8.0,2,0,0,,0,32,257,8.0,2
433,Malcolm Mitchell*\malcolm-mitchell-2,Georgia,SEC,8,31,248,8.0,3,0,0,,0,31,248,8.0,3
434,Ryan Jackson*\ryan-jackson-1,Houston,American,13,25,199,8.0,2,112,620,5.5,5,137,819,6.0,7
435,Heath Jackson*\heath-jackson-1,Bowling Green State,MAC,10,34,270,7.9,0,0,0,,0,34,270,7.9,0
436,Terron Ward\terron-ward-1,Oregon State,Pac-12,10,29,229,7.9,0,133,696,5.2,10,162,925,5.7,10
437,Davonte' Neal*\davonte-neal-1,Arizona,Pac-12,11,27,214,7.9,2,1,6,6.0,0,28,220,7.9,2
438,Brandon Burks\brandon-burks-1,Troy,Sun Belt,11,23,181,7.9,1,96,584,6.1,3,119,765,6.4,4
439,Devin Lucien*\devin-lucien-1,UCLA,Pac-12,12,29,225,7.8,2,1,34,34.0,0,30,259,8.6,2
440,Bill Belton*\bill-belton-1,Penn State,Big Ten,13,26,201,7.7,1,125,526,4.2,6,151,727,4.8,7
441,Paul Perkins*\paul-perkins-1,UCLA,Pac-12,13,26,201,7.7,2,250,1572,6.3,9,276,1773,6.4,11
442,Jalen Richard\jalen-richard-1,Southern Mississippi,CUSA,7,24,184,7.7,1,40,236,5.9,1,64,420,6.6,2
443,Devin Fuller*\devin-fuller-1,UCLA,Pac-12,13,59,447,7.6,1,1,-2,-2.0,0,60,445,7.4,1
444,Jarvis West\jarvis-west-1,Iowa State,Big 12,11,46,349,7.6,1,1,4,4.0,0,47,353,7.5,1
445,Marcus Murphy*\marcus-murphy-1,Missouri,SEC,14,28,212,7.6,1,177,924,5.2,4,205,1136,5.5,5
446,Michael Gordon*\michael-gordon-1,Arkansas State,Sun Belt,11,25,191,7.6,1,159,1100,6.9,13,184,1291,7.0,14
447,Devin Campbell\devin-campbell-1,Buffalo,MAC,10,24,182,7.6,4,33,161,4.9,0,57,343,6.0,4
448,Jamal Morrow\jamal-morrow-1,Washington State,Pac-12,12,61,460,7.5,0,87,351,4.0,0,148,811,5.5,0
449,Larry Rose III\larry-rose-iii-1,New Mexico State,Sun Belt,11,23,172,7.5,1,186,1102,5.9,9,209,1274,6.1,10
450,Nick Holley\nick-holley-1,Kent State,MAC,11,27,199,7.4,1,125,516,4.1,3,152,715,4.7,4
451,Devontae Booker*\devontae-booker-1,Utah,Pac-12,13,43,306,7.1,2,292,1512,5.2,10,335,1818,5.4,12
452,Stephen Nelson\stephen-nelson-1,SMU,American,10,28,200,7.1,0,0,0,,0,28,200,7.1,0
453,Darius Joseph\darius-joseph-1,SMU,American,10,54,379,7.0,2,1,4,4.0,0,55,383,7.0,2
454,Taquan Mizzell\taquan-mizzell-1,Virginia,ACC,12,39,271,6.9,0,64,280,4.4,2,103,551,5.3,2
455,Storm Woods\storm-woods-1,Oregon State,Pac-12,10,26,179,6.9,1,121,766,6.3,5,147,945,6.4,6
456,Kam Jones\kam-jones-1,UTSA,CUSA,12,34,232,6.8,0,25,69,2.8,1,59,301,5.1,1
457,Joshua Quezada*\joshua-quezada-1,Fresno State,MWC,13,33,223,6.8,1,134,525,3.9,5,167,748,4.5,6
458,Adam Humphries*\adam-humphries-1,Clemson,ACC,13,30,204,6.8,0,5,5,1.0,1,35,209,6.0,1
459,Travis Greene*\travis-greene-1,Bowling Green State,MAC,12,27,175,6.5,1,180,949,5.3,12,207,1124,5.4,13
460,Jalen Hurd*\jalen-hurd-1,Tennessee,SEC,13,35,221,6.3,2,190,899,4.7,5,225,1120,5.0,7
461,Tony Jones\tony-jones-7,Colorado,Pac-12,12,24,151,6.3,0,94,403,4.3,3,118,554,4.7,3
462,Gerard Johnson\gerard-johnson-1,Old Dominion,CUSA,11,24,149,6.2,0,100,493,4.9,1,124,642,5.2,1
463,Akeem Hunt\akeem-hunt-1,Purdue,Big Ten,12,48,293,6.1,2,173,949,5.5,6,221,1242,5.6,8
464,Tyler Cain\tyler-cain-1,Louisiana-Monroe,Sun Belt,12,45,273,6.1,0,63,214,3.4,0,108,487,4.5,0
465,Kevin Parks\kevin-parks-1,Virginia,ACC,12,30,179,6.0,2,189,745,3.9,4,219,924,4.2,6
466,Kenneth Harper\kenneth-harper-1,Temple,American,12,27,158,5.9,1,87,307,3.5,5,114,465,4.1,6
467,Tevin Coleman\tevin-coleman-1,Indiana,Big Ten,12,25,141,5.6,0,270,2036,7.5,15,295,2177,7.4,15
468,T.J. Logan*\tj-logan-1,North Carolina,ACC,13,26,144,5.5,0,119,582,4.9,3,145,726,5.0,3
469,Sherman Badie\sherman-badie-1,Tulane,American,12,24,108,4.5,1,121,688,5.7,3,145,796,5.5,4
470,Marteze Waller*\marteze-waller-1,Fresno State,MWC,14,27,120,4.4,0,225,1368,6.1,11,252,1488,5.9,11
